αἰσθάνομαι	to perceive; sense, understand	4
αἰτιάομαι	to accuse, censure; allege as a cause	4
αἱρέω	to take, grasp, seize; choose, elect	4
αἴτιος, α, ον	responsible; responsible for, cause of	3
βάρος, ους, τό	width	6
βοηθέω	to come to the aid of; come to the rescue	4
βουλεύω	to plan, devise; take counsel, deliberate	6
γέρας, ως, τό	gift of honor, privilege	5
δή	in fact, of course, certainly	2
διαδίδωμι	to hand over; distribute	3
διανοέομαι	to intend, be minded to; think, suppose; be disposed	4
διαφέρω	to carry across; endure, differ, excel	4
διαφθείρω	to destroy; corrupt, bribe; seduce; have been ruined, destroyed	2
δικάζω	to judge, serve as judge or juror; plead a case, participate in a suit	4
δυσσεβής, ές	impious, unholy	3
δυστυχής, ές	unlucky, unfortunate	3
δύσνους, ουν	ill-disposed, disaffected	3
εἴθε	would that	5
εἴπερ	if in fact, if indeed; since	3
θήρα, ας, ἡ	hunting, the chase	4
κλίνω	to cause to lean, slope, or lie down; lie down, recline	3
κομίζω	to take care of; carry, convey; acquire	5
κρήνη, ης, ἡ	well, spring	4
κόπτω	to strike, chop, beat; plunder (land); beat one's breast in mourning	3
μόγις	with toil; scarcely, hardly	3
νοέω	to perceive; apprehend; think, deem; intend	3
οὐσία, ας, ἡ	property; being, essence, reality, substance	3
παρασκευάζω	to prepare, provide, procure; prepare for oneself, make preparations	4
πλέω	to sail, go by sea	4
πλήττω	to strike	3
πλοῦς, πλοῦ, ὁ	voyage	3
πρέπει	it is fitting, it is becoming, it is seemly	4
προδίδωμι	to give in advance; give up, betray, abandon	5
προσίημι	to let come to; admit	4
πόνος, ου, ὁ	hard work, toil; suffering	4
πῆχυς, εος, ὁ	forearm, arm; cubit	7
σκοπέω	to look at; examine, consider	3
σπεύδω	to seek eagerly, strive; rush, hasten	5
σπουδάζω	to be serious, be earnest; be eager	5
στρατεύω	to carry out a military campaign, wage war; march	4
συγγιγνώσκω	to agree with; acknowledge; excuse, pardon	6
συμφέρω	to bring together; be advantageous	3
τέρας, ατος, τό	portent, sign, marvel; monster	4
τρέφω	to bring up, rear (children); nourish, maintain; cherish	5
φθάνω	to anticipate, be ahead of	4
φράζω	to point out, show; tell, declare, explain	5
χειμών, ῶνος, ὁ	winter; storm, stormy weather	2
χράομαι	to use, employ; experience	4
χράω	to proclaim an oracle; consult an oracle	2
χρηστὀς, ή, όν	useful, serviceable; good, honest, worthy	4
χρῆμα, ματος, τό	thing, matter, affair; (pl.) goods, property, money	4
ἀριστερός, ά, όν	on the left, left; ominous	4
ἁθροίζω	to gather together	5
ἁρπάζω	to snatch away, carry off; seize	5
ἄκων, ουσα, ον	unwilling, under constraint	2
ἆρα	indeed, truly	6
ἐξελέγχω	to prove; convict, refute	5
ἐπίσταμαι	to know how to; know, understand	4
ἐπαινέω	to approve, praise	3
ἐπιμέλομαι	to take care of, have charge of	3
ἐπιστέλλω	to send a message; order, command	4
ἐφίημι	to send on, send against; let go, yield; command, give orders; aim at, long for	5
ἔμπειρος, α, ον	experienced (in)	2
ἔπειτα	then, next; therefore	4
ἡττάομαι	to be less, be inferior; be defeated, be defeated by	4
ὑπομένω	to await; endure, stand up under	5
ὕστερος	latter, later, next	3
παρά + gen	from	4
ἄφεσις, εως, ἡ	release, pardon, forgiveness	4
ἀποκρίνομαι	to answer, reply, continue, begin	4
ἐφίστημι	to stand by, appear, attack	2
αἴρω	to take, take up, take away, remove	6
ὑπέρ + gen	for, in behalf of, about	4
ἐπιστρέφω	to turn, return	3
ὅτι	that, so that, because, for	3
παρίστημι	to place beside, present, render, approach, stand by	5
κατηγορέω	to accuse, bring charges against	2
ἄρτι	now, just, at once, immediately	5
πρός + gen	for	7
παρά + dat	beside, with	8
κράζω	to cry out, call out	3
ὑπάγω	to go away, go home, go	2
περί + acc	around, near	3
αἰτέω	to ask for, demand	4
κεῖμαι	to lie, recline, stand, be laid, be appointed, exist, be	4
ποῖος, α, ον	of what kind? which? what?	4
ἐπιλαμβάνομαι	to take hold of, catch, arrest, be concerned with, help	3
καθίστημι	to bring, apoint, ordain, make	6
ἐλέγχω	to bring to light, expose, convince, reprove, punish	5
ἐπί + acc	on, to, for, against	4
ἀπολύω	to set free, release, divorce	5
περί + gen	about, concerning, for	4
ἐπί + gen	on, over, when	5
ἀνίστημι	to raise, erect, bring to life, rise, stand up	2
παρατίθημι	to place before, put before	4
δέησις, εως, ἡ	prayer, entreaty, petition	7
μισθός, ά, όν	pay, wages, reward, punishment	5
πότε	when?	4
τοιοῦτος, αύτη, οῦτο	of such a kind, such	3
καταγγέλλω	to proclaim, make known	4
ἄποδίδωμι	to give away, give up, pay, return, reward	5
παραγγέλλω	to give orders, command, instruct, direct	6
καταργέω	to make ineffective, nullify, abolish	6
ὥστε	for this reason, therefore, so	4
διά + acc	because of	3
παραδίδωμι	to entrust, give up, hand over in custody	4
τοσοῦτος, αύτη, οῦτο	so great, so large, so many, so far, so much	5
ἀναιρέω	to take away, do away with, destroy, kill	5
παρά + acc	at, on, more than	2
ἐπι τίθημι	to lay upon, put upon, inflict upon, add, give, attack	1
κλαίνω	to weep, cry	3
παραλαμβάνω	to take, take along, recieve, accept	3
ἄρχι	until, to, as far as	2
ἐπιτρέπω	to allow, permit	1
παραγίνομαι	to come, arrive, appear, stand by	7
τάσσω	to marshal, draw up (troops); arrange; appoint	5
δικάζομαι	to participate in a law suit	1
δεινός, ή, όν	terrible	4
ἐπειδή	since	4
ἀποδίδομαι	to sell	4
ἀφίσταμαι	to revolt from	7
ἐφίσταμαι	to be in charge	6
καθίσταμαι	to be established	4
φαίνομαι	to seem	5
γε	at least	2
ἡδίων	more pleasant	3
θάττων	swifter	4
ἀμείνων	better	4
τοιόσδε	of this kind	6
πότερος	which two?	5
ὁπόθεν	whence-soever	5
πῃ	in some way	4
ἀλλαχόσε	in another direction	4
ἄλλοτε	at another time	4
αὐτόσε	in the same direction	4
καὶ μήν	and what is more	5
μέλω	to be a concern	5
προσήκει	it is fitting	3
ἔστε	until	3
ἐπιτήδεια, ων, τά	provisions	6
κατέχω	to <br/>restrain; hold fast to	5
ταράσσω	to <br/>be troubled; be disturbed	4
ὡσαύτως	likewise; similarly; same	3
διαλογίζομαι	to <br/>reason; consider; ponder	4
συλλαμβάνω	to <br/>seize; arrest; apprehend	5
χορτάζω	to <br/>be satisfied; fill	4
ἀθετέω	to <br/>reject; declare invalid	5
ἀνακρίνω	to <br/>examine; question; judge	3
καταλαμβάνω	to <br/>grasp; lay hold of	2
φρόνιμος, η, ον	wise; prudent	4
ἀναχωρέω	to <br/>withdraw; go away	4
ἀνθίστημι	to <br/>oppose; resist	5
ἀτενίζω	to <br/>look intently at; stare at	4
καταρτίζω	to <br/>complete; prepare; restore	2
ἄστοργος, η, ον	hardhearted; unfeeling	3
ἀφέλκω	to drag off	5
δικαστής, οῦ, ὁ	juryman, judge	5
εἰ γάρ	would that	4
εὐσεβής, ές	pious, dutiful	4
τρόπος, ου, ὁ	turn; way, manner, fashion; habits, character	2
ἀπάγω	to lead away; arrest, carry off to prison	4
ἀπορέω	to be without means or resources; be at a loss, be in doubt; lack	6
ἐκείνως	in that manner	5
ἐνθάδε	here, then	6
ὑπισχνέομαι	to undertake; promise, profess	4
μεριμνάω	to have anxiety, be anxious, care for	4
κωλύω	to hinder, prevent, forbid, restrain, withhold	3
σήμερον	today	3
ἄρα	so, then, consequently, perhaps	4
παρακαλέω	to call, invite, urge, implore	4
δέχομαι	to take, recieve, welcome	4
μισθός, ού, ὁ	pay, wages, reward, punishment	4
ἀφίστημι	to cause to revolt	6
συμφέρει	it is beneficial	6
ἐνταῦθα	there	5
ἐνθένδε	from here	3
ἐκεῖσε	to that place	6
συνίστημι	to <br/>recommend; commend	5
κωφός	deaf; mute; unable to speak	4
χρηματίζω	to <br/>be called; warn; be named	6
ἀσέβεια, ας, ἡ	ungodliness; impiety	5
ἀποβαίνω	to <br/>get out; turn out; lead to	2
οἰκτίρω	to <br/>have compassion on	3
προσαγορεύω	to <br/>call; name; designate	3
ὐφαιρέομαι	to steal, take for oneself by stealth	4
ἀφαιρέομαι	to set up, make, place, put ... in ...	3
ἐπιτίθημι	to place on	6
εὐτυχής, ές	well-born; noble, noble-minded	7
μάλιστα	most	4
μνήμων, ονος, ὁ or ἡ	mindful, remembering, unforgetting	4
λανθάνω	to escape notice	5
οἰκητήριον	dwelling; habitation	6
εὐγενής, ές	lucky, fortunate	5
σώφρων, ονος, ὁ or ἡ	of sound mind; prudent; self-controlled; temperate, chaste	4
φύσις, εως, ἡ	origin, birth, growth; nature	4
ῥύομαι	to <br/>rescue; deliver	4
φάσκω	to <br/>assert; claim	5
ἀγωνίζομαι	to <br/>struggle; fight; strive	4
ἐμφανής, ές	visible; known	3
μηχανή, ῆς, ἡ	device, plan	5
διαμένω	to continue, persist, last	4
παραινέω	to exhort, advise	5
σπένδω	to pour a libation; exchange libations, make a truce, make peace	5
ἔρις, ιδος, ἡ	strife, quarrel, rivalry	3
γένος, ους, τό	race, descendant, family, nation, class	3
ἐπιγινώσκω	to know, understance, recognize, learn, notice, know well	4
δύομαι	to dive	5
ἀποκρίνω	to separate	6
ὁπόσος	however much	5
ἐκδέχομαι	to <br/>wait for; expect	7
γνήσιος, α, ον	sincere; true; genuine	3
λαγχάνω	to <br/>receive; obtain	5
ἐξετάζω	to <br/>ask; inquire; question	5
τεκμήριον, ου, τό	proof; convincing proof	5
ἀπέχομαι	to refrain, keep away (from)	4
καίτοι	and yet	5
πότερον	whether	6
σπουδή, ῆς, ἡ	haste, speed; trouble, effort; regard, esteem, good wheel	5
συμβαίνω	to come together; come to an agreement, come to terms; come to pass, happen	5
ἐξαπατάω	to cheat, deceive, trick	5
ἀσθενέω	to be weak, powerless, sick, in need	3
ᾗ	in which way	5
συγγίγνομαι	to be with, have intercourse with	6
εἰκότως	reasonably, rightly	4
ποτε	at any time	5
προθυμέομαι	to be ready, eager	6
συνίημι	to understand, comprehend	3
ἐγγυάω	to engage, promise	4
ἔλεγχος, εος, τό	proof; proving	4
προτρέπω	to <br/>encourage; urge (on)	4
ἀνέχω	to hold up; rise up; bear up, endure, put up with	4
ἐξαιτέω	to ask for… from; demand for oneself; beg off, appeal for pardon	3
ἵσταμαι	to stand up	3
ἄχρι	until	4
πάνυ	very, exceedingly; altogether	3
ὑπολαμβάνω	to take up; understand, interpret; assume; reply, rejoin	4
ὠφελέω	to help, aid	4
ὁπότερος, α, ον	whichever of two	4
ἐντυγχάνω	to <br/>appeal; intercede	4
εὐπρεπής, ές	seemingly, proper, becoming	3
κτάομαι	to acquire, get; possess, hold, have	4
συντυγχάνω	to <br/>meet; come together with	4
τοίνυν	well then; therefore; moreover	5
ἀπαγγέλλω	to report, announce, tell, proclaim	4
μὲν οὖν	now then	4
ποιός, ά, όν	of some sort	4
ἐπέχω	to <br/>hold fast; fix attention on	4
ἐπικαλέομαι	to call upon	4
αἰδώς, ους, ἡ	awe; sense of shame; respect for others	4
δήπου	surely, doubtless, I presume	4
εἶτα	then, next; accordingly, therefore	4
συμβουλεύω	to advise, counsel, consult with	5
σωφροσύνη, ης, ἡ	prudence; moderation, temperance	4
ἀσφαλής, ές	steadfast; safe, secure; trustworthy	3
ἄγαν	very much; too much	2
ἅλις	sufficiently, enough	3
παρρησία, ας, ἡ	outspokenness, openness, boldness, confidence	3
ἐπικαλέω	to call, name	3
συμβαίνει	it happens	4
ποθεν	from some place	4
ὅποι	whither-soever	4
ἐκτείνω	to <br/>stretch out; extend	4
προσδέχομαι	to <br/>wait for; look forward to	5
διάνοια, ας, ἡ	mind; disposition	5
ἀπολαμβάνω	to <br/>receive; get back; recover	3
ἐπιδημέω	to <br/>stay; be in town	3
μέτριος, α, ον	fair, moderate, reasonable	4
οὐδαμῶς	by no means	4
ἀποβλέπω	to <br/>look; pay attention	3
βαρύς, εῖα, ύ	heavy	4
θρασύς, εῖα, ύ	bold, rash, audacious	4
παραβαίνω	to go beside; overstep, transgress, violate	4
παχύς, εῖα, ύ	thick, stout	4
περιοράω	to look over; overlook; permit, look upon while doing nothing	4
πρόθυμος, η, ον	ready, willing, eager; bearing good will	4
σαφής, ές	sure, reliable; clear, distinct	5
ἀσαφής, ές	indistinct, uncertain	4
ἀφικνέομαι	to arrive at, come to, reach	4
ἁλίσκομαι	to be captured, be seized	4
ἐπιορκία, ας, ἡ	false swearing, perjury	4
ἐπιβάλλω	to throw over, lay on, put on, sew on, beat upon, belong to	4
αἱρέομαι	to choose	4
οἷος	as, the sort which	4
τοσόσδε	this much	3
οἴκαδε	to home	4
πλησίον	neighbor	4
προσδοκάω	to <br/>wait for; look for; expect	4
καταισχύνω	to <br/>put to shame; humiliate	3
διηγέομαι	to <br/>describe; tell; relate	4
διαλείπω	to <br/>stop; cease	4
ἀποφαίνω	to reveal, show	3
εἰκός, ότος, τό	likely, probable, reasonable, fair	4
συγχωρέω	to agree with, to agree to; to yield to	4
παραγίγνομαι	to be present, turn up at	4
γιγνώσκω	to get to know	4
ἐπιεικής, ές	gentle; kind; tolerant	4
διατίθημι	to <br/>arrange; decree; ordain	4
διαβαίνω[sound:rec1606689203.mp3]	to step across; go over, cross	4
ἀμφοτέρωσε[sound:rec1606691992.mp3]	in both directions	4
σπουδαῖος, α, ον[sound:rec1606692151.mp3]	diligent; eager; earnest	4
καθοράω[sound:rec1606692211.mp3]	to <br/>discern clearly	4
ὑποδέχομαι[sound:rec1606692871.mp3]	to <br/>receive; welcome	4
φόρος, ου, ὁ[sound:rec1606691726.mp3]	payment, tribute	4
κοιμάω[sound:rec1606690867.mp3]	to sleep, fall asleep, die	4
οὐ μὴν ἀλλά[sound:rec1607101854.mp3]	but even so	4
ὑφαιρέομαι[sound:rec1607440431.mp3]	to steal, take for oneself by stealth	4
μέντοι[sound:rec1606690280.mp3]	however	4
ἀπέχω[sound:rec1606692759.mp3]	to recieve in full, am enough, am distant	4
ἀπαιτέω[sound:rec1607100897.mp3]	to <br/>ask for; demand	4
ἐνθυμέομαι[sound:rec1606693740.mp3]	to <br/>think; consider	4
βουλεύομαι[sound:rec1606693125.mp3]	to discuss, take advice	4
φόρος, ου, ὁ[sound:rec1606691726.mp3][sound:rec1608242234.mp3]	payment, tribute	4
σπουδαῖος, α, ον[sound:rec1608242387.mp3]	diligent; eager; earnest	4
νομή, ῆς, ἡ[sound:rec1606691138.mp3]	pasture; spreading	4
ὑποδέχομαι[sound:rec1608350488.mp3]	to <br/>receive; welcome	4
νομή, ῆς, ἡ[sound:rec1608349870.mp3]	pasture; spreading	4
οἴχομαι[sound:rec1606692289.mp3]	to be off, depart	4
ζηλόω[sound:rec1606689792.mp3]	to vie with, emulate; admire, praise	4
ἐπιτίθεμαι[sound:rec1606692775.mp3]	to attack	4
φόρος, ου, ὁ[sound:rec1608571457.mp3]	payment, tribute	4
σπουδαῖος, α, ον[sound:rec1608571852.mp3]	diligent; eager; earnest	4
ὑφαιρέομαι[sound:rec1608571905.mp3]	to steal, take for oneself by stealth	4
οἴχομαι[sound:rec1608571403.mp3]	to be off, depart	4
ζηλόω[sound:rec1609609946.mp3]	to vie with, emulate; admire, praise	4
πρότερος[sound:rec1608571553.mp3]	former, earlier, previous	4
φύω[sound:rec1607101707.mp3]	to produce, make grow; beget; grow, be begotten, be born; be by nature prone to	4
δέομαι[sound:rec1607555170.mp3]	to ask, beg, pray	4
πως[sound:rec1609609761.mp3]	somehow	4
ταύτῃ[sound:rec1606692792.mp3]	in that way	4
ἀμφοτέρωσε[sound:rec1609609768.mp3]	in both directions	4
παραιτέομαι	to <br/>refuse; reject; excuse; beg	4
ὑποδέχομαι[sound:rec1609609772.mp3]	to <br/>receive; welcome	4
νομή, ῆς, ἡ[sound:rec1609609677.mp3]	pasture; spreading	4
ἀμελής, ές[sound:rec1609609806.mp3]	uncaring	4
ἀναλίσκω	to spend, use, kill	4
διαβαίνω	to step across; go over, cross	4
ζηλόω	to vie with, emulate; admire, praise	4
μέντοι	however	4
πρότερος	former, earlier, previous	4
φόρος, ου, ὁ	payment, tribute	4
φύω	to produce, make grow; beget; grow, be begotten, be born; be by nature prone to	4
δέομαι	to ask, beg, pray	4
κοιμάω	to sleep, fall asleep, die	4
ἀπέχω	to recieve in full, am enough, am distant	4
πως	somehow	4
ἐπιτίθεμαι	to attack	4
ταύτῃ	in that way	4
ἀμφοτέρωσε	in both directions	4
οὐ μὴν ἀλλά	but even so	4
ὑποδέχομαι	to <br/>receive; welcome	4
σπουδαῖος, α, ον	diligent; eager; earnest	4
νομή, ῆς, ἡ	pasture; spreading	4
ἀπαιτέω	to <br/>ask for; demand	4
ἐνθυμέομαι	to <br/>think; consider	4
καθοράω	to <br/>discern clearly	4
ὑφαιρέομαι	to steal, take for oneself by stealth	4
ἀμελής, ές	uncaring	4
οἴχομαι	to be off, depart	4
βουλεύομαι	to discuss, take advice	4
